GIGI - MQMQ
HALA - OAWA
JBEG - SCIM
BEAJ - CIAS
BEAG - CIAM
CIAK - EQAU
EADI - IAGQ
AFKG - AKUM
HEAD - OIAG
BEEF - CIIK
BEEG - CIIM
CBBL - ECCW
GBBL - MCCW
GELB - MIWC
CBEE - ECII
DADB - GAGC
GBGA - MCMA
GBLA - MCWA
IBLA - QCWA
IEEA - QIIA
GBFF - MCKK
JHJH - SOSO
DHAL - GOAW
AHLL - AOWW
BFFF - CKKK
KLEE - UWII
HAMB - OAYC
CEEF - EIIK
KEKA - UIUA
ABED - ACIG
ACAI - AEAQ
GAHE - MAOI
FELE - KIWI
JIAD - SQAG
LIAK - WQAU
CBAG - ECAM
LAMB - WAYC
EEFG - IIKM
CBFG - ECKM
DEAG - GIAM
CFAM - EKAY
MLFA - YWKA
EDDI - IGGQ
CABE - EACI
BEMG - CIYM
MBMB - YCYC
BGGB - CMMC
MHGA - YOMA
AIEF - AQIK
BGEE - CMII
BEAM - CIAY
LHLM - WOWY
BIEB - CQIC
BBLA - CCWA
KHKA - UOUA
BELA - CIWA
MEEB - YIIC
MBIB - YCQC
GALB - MAWC
GIEB - MQIC
JBGB - SCMC
CAGA - EAMA
GBCB - MCEC
GELA - MIWA
CABB - EACC
LADB - WAGC
LIDB - WQGC
LBLB - WCWC
JALL - SAWW
IIDA - QQGA
IAFC - QAKE
GAMA - MAYA
DEDB - GIGC
GBMA - MCYA
GEMA - MIYA
CBEG - ECIM
GAGH - MAMO
LADB - WAGC
GEEG - MIIM
KAKA - UAUA
GBMJ - MCYS
IIAI - QQAQ
CHIC - EOQE
CAEG - EAIM
GILB - MQWC
GBMM - MCYY
EIGL - IQMW
JBAB - SCAC
AFGE - AKMI
HEEM - OIIY
GEEA - MIIA
MBEC - YCIE
FAAD - KAAG
AEAB - AIAC
FLDB - KWGC
FLLL - KWWW
MBEA - YCIA
DBGF - GCMK
FHAA - KOAA
BBCF - CCEK
